.==========.
|..........!
|..........!
|..........!
|..........!
|..........!
|..........!
|..........!
|..........!
|..........!
............
