312 612
                            
                            
                            
(============)(============)
|............|!............!
|.(==).(===).|!.(===).(==).!
| |..!.|...!.|!.|...!.|..! !
|.[--].[---].[].[---].[--].!
|..........................!
|.(==).().(======).().(==).!
|.[--].|!.[--)(--].|!.[--].!
|......|!....|!....|!......!
[----).|[==) |! (==]!.(====]
     |.|(--] [] [--)!.!     
     |.|!          |!.!     
     |.|! (------) |!.!     
=====].[] !      | [].[=====
      .   !      |   .      
-----).() !      | ().(-----
     |.|! [======] |!.|     
     |.|!          |!.|     
     |.|! (======) |!.|     
(====].[] [--)(--] [].[====)
|............|!............!
|.(==).(===).|!.(===).(==).!
|.[-)!.[---].[].[---].|(-].!
| ..|!.......  .......|!.. !
[=).|!.().(======).().|!.(=]
(-].[].|!.[--)(--].|!.[].[-)
|......|!....|!....|!......!
|.(====][==).|!.(==][====).!
|.[--------].[].[--------].!
|..........................!
[--------------------------]
                            
                            
