84 84
(==========)
|*........*!
|.(======).!
|.[--)(--].!
|*..*|!*..*!
|.().|!.().!
|.[].[].[].!
|*..*..*..*!
[==).().().!
(--].[].[].!
|...*..*..*!
[----------]
