312 612
............................
............................
............................
(============)(============)
|............|!............!
|.(==).(===).|!.(===).(==).!
|.|..!.|...!.|!.|...!.|..!.!
|.[--].[---].[].[---].[--].!
|..........................!
|.(==).().(======).().(==).!
|.[--].|!.[--)(--].|!.[--].!
|......|!....|!....|!......!
[----).|[==).|!.(==]!.(====]
.....|.|(--].[].[--)!.!.....
.....|.|!..........|!.!.....
.....|.|!.(------).|!.!.....
=====].[].!......|.[].[=====
..........!......|..........
-----).().!......|.().(-----
.....|.|!.[======].|!.|.....
.....|.|!..........|!.|.....
.....|.|!.(======).|!.|.....
(====].[].[--)(--].[].[====)
|............|!............!
|.(==).(===).|!.(===).(==).!
|.[-)!.[---].[].[---].|(-].!
|...|!................|!...!
[=).|!.().(======).().|!.(=]
(-].[].|!.[--)(--].|!.[].[-)
|......|!....|!....|!......!
|.(====][==).|!.(==][====).!
|.[--------].[].[--------].!
|..........................!
[--------------------------]
............................
............................
