(==========)
|..........!
|.(======).!
|.[--)(--].!
|....|!....!
|.().[].().!
|.[]....[].!
|..........!
[==).().().!
(--].[].[].!
|..........!
[----------]
